"filename", "language", "Dart", "comment", "blank", "total"
"/Users/Projects/Flutter/grow_run_v1/test/features/grow/data/repositories/authentication_repository_test.dart", "Dart", 54, 12, 11, 77
"/Users/Projects/Flutter/grow_run_v1/test/features/grow/data/repositories/child_repository_test.dart", "Dart", 205, 36, 26, 267
"/Users/Projects/Flutter/grow_run_v1/test/features/grow/data/repositories/grow_repository_test.dart", "Dart", 0, 60, 9, 69
"/Users/Projects/Flutter/grow_run_v1/test/features/grow/data/repositories/parent_repository_test.dart", "Dart", 154, 28, 17, 199
"/Users/Projects/Flutter/grow_run_v1/test/features/grow/domain/repositories/database_repository.test.dart", "Dart", 0, 0, 1, 1
"/Users/Projects/Flutter/grow_run_v1/test/features/grow/domain/usecases/child/disable_child_acc_test.dart", "Dart", 0, 0, 1, 1
"/Users/Projects/Flutter/grow_run_v1/test/features/grow/domain/usecases/child/edit_child_test.dart", "Dart", 0, 0, 1, 1
"/Users/Projects/Flutter/grow_run_v1/test/features/grow/domain/usecases/child/enable_child_test.dart", "Dart", 0, 0, 1, 1
"/Users/Projects/Flutter/grow_run_v1/test/features/grow/domain/usecases/child/get_children_by_id_test.dart", "Dart", 0, 0, 1, 1
"/Users/Projects/Flutter/grow_run_v1/test/features/grow/domain/usecases/child/get_children_by_school_test.dart", "Dart", 1, 0, 1, 2
"/Users/Projects/Flutter/grow_run_v1/test/features/grow/domain/usecases/child/get_children_test.dart", "Dart", 6, 0, 2, 8
"/Users/Projects/Flutter/grow_run_v1/test/features/grow/domain/usecases/child/register_new_child_user_test.dart", "Dart", 90, 9, 12, 111
"/Users/Projects/Flutter/grow_run_v1/test/features/grow/domain/usecases/child/register_new_child_user_test.mocks.dart", "Dart", 98, 11, 9, 118
"/Users/Projects/Flutter/grow_run_v1/test/features/grow/domain/usecases/child/sign_up_new_child_user_test.dart", "Dart", 105, 13, 16, 134
"/Users/Projects/Flutter/grow_run_v1/test/features/grow/domain/usecases/child/sign_up_new_child_user_test.mocks.dart", "Dart", 98, 11, 9, 118
"Total", "-", 811, 180, 117, 1108